20 20
.B..B...B...BB.B....
......B..........B..
..B.......B.........
...B......B.........
...BB.........B.....
.......B.....B......
..B.BB..B.......B...
.BB.................
......B.......B.....
.....B......B.....B.
........B...........
...........B.....B.B
.............B.B....
BB.....B....B...BB.B
..........B.....B...
.............B.B....
....B......B........
....B....B....B.B...
.......B............
.........B..........
