10 10
BBBBB...BB
..BBB.B.BB
B...B.B.BB
B.B...B.BB
B.BBBBB.BB
B...BBB...
BBB.BBBBB.
BBB...BB..
BBBBB....B
BBBBBBBBBB
